******************
*P               *
*      MM        *
*                *
*   **   M       *
*                *
*                *
*                *
*      * *       *
*      *G*       *
******************